1 1 28 1
10 7 10 1
8 12 6 1
16 12 6 1
6 17 18 1
4 22 6 1
12 22 6 1
20 22 6 1
1 26 28 1