1 1 28 1
10 5 10 1
8 10 6 1
16 10 6 1
6 15 20 1
4 20 6 1
12 20 6 1
20 20 6 1
1 26 28 1