1 1 7 1
12 1 6 1
22 1 7 1

7 2 1 1
22 2 1 1

7 3 3 1
20 3 3 1

4 7 9 1
17 7 9 1

4 8 1 1
11 8 2 1
17 8 2 1
25 8 1 1

4 9 1 1
11 9 2 1
17 9 2 1
25 9 1 1

4 10 1 1
11 10 2 1
17 10 2 1
25 10 1 1

4 11 4 1
11 11 2 1
17 11 2 1
22 11 4 1

11 12 2 1
17 12 2 1
11 13 2 1
17 13 2 1
11 14 2 1
17 14 2 1
11 15 2 1
17 15 2 1

4 16 4 1
22 16 4 1
4 17 1 4
25 17 1 4
4 21 7 1
14 21 2 1
19 21 7 1

1 26 7 1
12 26 6 1
22 26 7 1