1 1 7 1
12 1 6 1
22 1 7 1


1  6 6 1
23 6 6 1


1  11 8 1
21 11 8 1

1  16 10 1
19 16 10 1

3  21 10 1
17 21 10 1



1 26 7 1
12 26 6 1
22 26 7 1
