1 1 7 1
12 1 6 1
22 1 7 1


4 6 25 1

1 11 25 1

4 16 25 1

3 21 11 1
16 21 11 1



1 26 7 1
12 26 6 1
22 26 7 1