1 1 28 1
1 11 2 1
16 10 1 1
6 11 18 1
16 11 1 11
27 11 2 1
1 16 2 1
6 16 18 1
27 16 2 1
1 21 2 1
6 21 18 1
27 21 2 1
1 26 28 1